NO /Users/skasmi/Desktop/cubemerged/xpm_files/TECH_1A_1.xpm
C     250   ,   30  ,   0
SO /Users/skasmi/Desktop/cubemerged/xpm_files/TECH_2A_1.xpm




      WE         /Users/skasmi/Desktop/cubemerged/xpm_files/TECH_1A_1.xpm
F         255     ,      100    ,    0
EA /Users/skasmi/Desktop/cubemerged/xpm_files/TECH_1A_1.xpm






1111111111111111111111
1000000000000000000001
1000000000000000000001
100000000S00001000001
1000000000000000000001
1000000000000000011101
1000000000000000000001
1111111111111111111111