NO /Users/skasmi/Desktop/cubemerged/xpm_files/TECH_1A_1.xpm
C     250   ,   30  ,   0
SO /Users/skasmi/Desktop/cubemerged/xpm_files/TECH_2A_1.xpm




      WE         /Users/skasmi/Desktop/cubemerged/xpm_files/TECH_1A_1.xpm
F         255     ,      100    ,    0
EA /Users/skasmi/Desktop/cubemerged/xpm_files/TECH_1A_1.xpm



1111111111111111111111111
1000000000000000000000001    
1000000000000000000000001
1000000000000000000000001
1000000000000000000000001
1000000000000000000000001
1000000000000000000000001
111111111000000000000000111111111         
1000000000000000000000001
111111111000000000000000011111111
10000000000001000000000000001                                                  
100000000000S0100000000000001                                                    
10000000000000000000000000001                                                
11000000110101011100000010001           
111111111000000011000000100011111111111111111111111111
        1000000000110000000000001100000000011000001111
        1000001111111111111111001100000000011000001111 
        1000001              1000000000000000111000000111111
111111111000001              110000001000110000000001100000111
100000000000001              1010101001000110000000001100000111                              
111111111000001              111100000000001111000000000110001                               
100000000000001              11110111111111111111111111111111
111101111000011              110000001000110111           
10000000000000111111111111111100000000011000001111111111
10000000000000001101010010001100000000011000001110100001
10000000000000001101010011111111111111011000010000111111
11110111100001011101010011        111111111111111101   
11000000100001011100000011     11110000000011000001111111111111111       
11111111100000001100000011     11100000000011000001110111111111111           
        100001111111111111     111111100000000011000001110111111111111           
        100000000011000001     100001100000000011000001110111111111111           
        100000000111000001     100001100000000011000001110111111111111           
        100000000000000001     111111111111111111111111111100000000001           
11111111100000000111000001                                100111100011111111111111111
10000000000000000111011111                                111111100000000011000001110111
11110111100001011100000011                                1110000000001100000111000000001111
11110111100001011101010011                                10000000000000000001100000000000011
11000000100001011100000011                                10000000000011000001110111111111111
10000000000000001100000011                                1100001110111111111111100001111111
11110111111111011111111111                                10000000000011000111111111111
1111011111111101                                          111111111111111111           
1100000011010101                              
1000000000000001                   111111111
1000000000000001                   110010001
1111011111111101                   100010001111111111111111111         
11110111111111011111111111111111111100000000000000000110000011
11000000110101011100000010000000000000000000000000000000000001
11000000110101011100000010001111111111111111111111111111111111
10000000000000001100000010001
10000000000000001101010010001
11110111111111011101010010001
1100000011010101110000001000111111111111111111111111111111111111111111111111111111
1100000011010101110000001000000000000000000000000000000000000000000000000000000001
1100000011010101110000001000000000000000000000000000000000000000000000000000000001
1100000011010101110000001000111111111111111111111111111111111111111111111111111111
11000000110101011100000010001
10000000000000001100000010001
10000000000000001101010010001
11110111111111011100000010001
11110111111111011101010010001
11000000110101011100000010001
10000000000000001100000010001
10000000000000001101010010001
11000001111101011111111110001
11110111  1110101   101111011
11111111  1111111   111111111